1111111111111111111111111111111111111111111111111111111111111111111111111111111111111111111111111111111111111111
1111111111111111111111111111111111111111111111111111111111111111111111111111111111111111111111111111111111111111
1111000000000001110000000000000111100011111111111111000000000000001111000011111111110001111000000000000000001111
1111000000000001110000000000000111100011111111111111000000000000001111000001111111110001111000000000000000001111
1111000111111111110001111111000111100011111111111111000111111110001111000100011111110001111000111111111111111111
1111100011111111110001111111000111100011111111111111000111111110001111000110001111110001111000111111111111111111
1111110001111111110001111111000111100011111111111111000111111110001111000111000111110001111000111111111111111111
1111111000111111110001111111000111100011111111111111000111111110001111000111100011110001111000111111100000001111
1111111100011111110001111111000111100011111111111111000111111110001111000111110001110001111000111111100000001111
1111111110001111110001111111000111100011111111111111000111111110001111000111111000110001111000111111111110001111
1111111111000111110001111111000111100011111111111111000111111110001111000111111100010001111000111111111110001111
1111000000000011110000000000000111100000000000001111000000000000001111000111111111000001111000000000000000001111
1111000000000011110000000000000111100000000000001111000000000000001111000111111111100001111000000000000000001111
1111011111111111110111111111111111101111111111111111011111111111111111011111111111111111111011111111111111111111
1111PC0C0C0C00C0C0C0C00C0C0C0C00C0C0C0C00C0C0C0C0C0C0C0C0C00C0C0C0C00C0C0C0C00C0C0C0C00C0C0C0C00C0C0C0C00C0E1111
1111111111111111111111111111111111111111111111111111111111111111111111111111111111111111111111111111111111111111
1111111111111111111111111111111111111111111111111111111111111111111111111111111111111111111111111111111111111111
