1111111111111
1C0000000C001
1110011111101
1P100000E1001
1111111111111