1111111111111
11110000000C1
1110011111001
1P1111E111001
1111111111111
