0001111111011
00010000000C1
0000011111000
1P0011E000000
1100111000000
