1111111111111
1001000C1
1000011111001
1P0011E001
111111111111
